{
  "width": 100,
  "height": 13,
  "data": [
    "1111111111111111111111111111111111111111111111111111111111111111111111111111111111111111111111111111",
    "1000000000000000000000000000000000000000000000000000000000000000000000000000000000000000000000000001",
    "1000000000000000000000000000000000000000000000000000000000000000000000000000000000000000000000000001",
    "1000000000000000000000000000000000000000000000000000000000000000000000000000000000000000000000000001",
    "1000000000000000000000000000000000000000000000000000000000000000000000000000000000000000000000000001",
    "1000000000000000000000000000000000000000000000000000000000000000000000000000000000000000000000000001",
    "10000000000000000000000000000PPP00000000000000000000000000000000000000000000000000000000000000000001",
    "1000000000000000000000000000000000000000000000000000000000000000000000000000000000000000000000000001",
    "1000000000000000000000000000000000000000000000000000000000000000000000000000000000000000000000000001",
    "100000000000000000000000000000000000000000000000000000PPP0000000000000000000000000000000000000000001",
    "1000000000000000000000000000000000000000000000000000000000000000000000000000000000000000000000000001",
    "1000000000000000000000000000000000000000000000000000000000000000000000000000000000000000000000000001",
    "10000PPP0000000000000000000000000000000000000000000000000000000000000000000000000000PPP000000000001",
    "1000000000000000000000000000000000000000000000000000000000000000000000000000000000000000000000000001",
    "1000000000000000000000000000000000000000000000000000000000000000000000000000000000000000000000000001",
    "1000000000000000000000000000000000000000000000000000000000000000000000000000000000000000000000000001",
    "1111222111111000111111110001111111111000111111111111111222111111000111111110001111111111000111111111"
  ]
}
