{
  "width": 120,
  "height": 13,
  "data": [
    "111111111111111111111111111111111111111111111111111111111111111111111111111111111111111111111111111111111111111111111111",
    "100000000000000000000000000000000000000000000000000000000000000000000000000000000000000000000000000000000000000000000001",
    "100000000000000000000000000000000000000000000000000000000000000000000000000000000000000000000000000000000000000000000001",
    "100000000000000000000000000000000000000000000000000000000000000000000000000000000000000000000000000000000000000000000001",
    "100000000000000000000000000000000000000000000000000000000000000000000000000000000000000000000000000000000000000000000001",
    "100000000000000000000000000000000000000000000000000000000000000000000000000000000000000000000000000000000000000000000001",
    "10000000000000000000000000000PPP0000000000000000000000000000000000000000000000000000000000000000000000000000000000000001",
    "100000000000000000000000000000000000000000000000000000000000000000000000000000000000000000000000000000000000000000000001",
    "100000000000000000000000000000000000000000000000000000000000000000000000000000000000000000000000000000000000000000000001",
    "100000000000000000000000000000000000000000000000000000PPP000000000000000000000000000000000000000000000000000000000000001",
    "100000000000000000000000000000000000000000000000000000000000000000000000000000000000000000000000000000000000000000000001",
    "100000000000000000000000000000000000000000000000000000000000000000000000000000000000000000000000000000000000000000000001",
    "10000PPP0000000000000000000000000000000000000000000000000000000000000000000000000000PPP0000000000000000000000000000000001",
    "100000000000000000000000000000000000000000000000000000000000000000000000000000000000000000000000000000000000000000000001",
    "100000000000000000000000000000000000000000000000000000000000000000000000000000000000000000000000000000000000000000000001",
    "100000000000000000000000000000000000000000000000000000000000000000000000000000000000000000000000000000000000000000000001",
    "11112221111110001111111100011111111110001111111111111112221111110001111111100011111111110001111111111111111111111111"
  ]
}
